1111111
10000P1
1E00C11
1111111