1111111111111111111
1111111111111111111
1000000000000000101
1000000C0C000000101
1111111111111011111
10000000C0100000001
1000000001E10000001
1000000000000100001
10000C0000000C11001
10000000000001P0001
1111111111111111111